+---+---+---+---+---+
| E |||||||||||||||||
+   +---+---+---+---+
| C   D   D   D   L |
+   +---+---+---+   +
| L ||||||||||||| C |
+   +---+---+---+   +
| C   D   T ||||| T |
+---+---+   +---+   +
||||||||| D ||||| D |
+---+---+   +---+   +
||||||||| C   D   C |
+---+---+---+   +---+
||||||||||||| D |||||
+---+---+---+   +---+
||||||||||||| ^ |||||
+---+---+---+---+---+
